NO ./maps/test1
SO ./maps/test2
WE ./maps/test3
EA ./maps/test4

F 220,100,0
C 225,30,253

1111111111111111111   
1000000000101101011   
1110000111101101011   
  100001 1001011011111
1110000111101101011   
1000000000101101011   
1000000000101101011   
1111111111111111111   