NO ./maps/test1
SO ./maps/test2
WE ./maps/test3
EA ./maps/test4

C 135,206,235
F 220,100,40

1111111111111111111
1000000000101101011
1000000000001101011
1000E00001011011111
1000000000001101011
1000000000101101011
1000000000101101011
1000000000101101011
1000000000100001011
1000000000101101011
1000000000101101011
1000000000101101011
1111111111111111111