     111 1111111111111 
     101 10011100000011
     101 1001110111111 
11111100100000001      
10111000000000001      
11111111111111111      